1111111111111
1C000000000C1
1000011111001
1P0C0E01C0001
1111111111111
