1111111111111
1C000000000C1
1100011111001
1P000E01000001
111111111111001
