1111111111111
1C000000000C1
1100011111001
1P0000E100001
1111111111111
    